20 20
1 1 1 1 1 1 1 1 1 1 1 1 1 1 1 1 1 1 1 1
1 0 0 0 0 0 0 0 0 2 0 0 0 0 0 0 0 0 0 1
1 0 0 0 9 0 0 0 9 2 0 0 0 0 0 0 0 0 0 1
1 0 0 0 2 2 2 2 2 2 0 0 0 0 0 0 0 0 0 1
1 0 0 0 0 0 0 2 0 2 0 0 0 2 0 9 0 0 0 1
1 0 9 0 0 0 0 2 0 2 0 0 0 2 0 0 0 0 9 1
1 0 9 0 0 0 0 2 0 2 0 0 0 2 0 0 0 0 0 1
1 0 0 0 0 0 0 2 0 2 0 2 2 2 0 0 0 0 0 1
1 2 2 2 2 0 0 2 2 2 0 0 0 2 0 0 0 0 0 1
1 0 0 0 0 0 0 0 0 2 0 0 0 2 0 0 0 0 0 1
1 0 0 0 9 0 0 0 0 2 0 0 0 2 0 0 0 0 0 1
1 9 0 0 0 0 0 0 0 2 0 0 0 2 0 0 0 0 0 1
1 0 0 0 2 2 2 2 2 2 2 9 0 2 0 0 0 0 0 1
1 0 0 0 0 0 0 0 0 2 0 0 0 2 0 0 9 0 0 1
1 0 0 0 0 0 0 0 0 2 0 0 0 2 0 0 0 0 0 1
1 0 0 0 2 0 0 0 0 2 0 0 0 2 0 0 0 0 0 1
1 0 5 0 2 0 9 0 0 2 2 0 0 2 0 0 0 0 0 1
1 0 0 0 2 0 0 0 0 0 0 0 0 2 0 0 0 0 0 1
1 0 0 0 2 0 0 0 0 0 0 0 0 2 0 0 0 0 0 1
1 1 1 1 1 1 1 1 1 1 1 1 1 1 1 1 1 1 1 1